R 600 600
NO ./textures/int.xpm
SO ./textures/wood.xpm
WE ./textures/purplestone.xpm
EA ./textures/redbrick.xpm
S ./textures/barrel.xpm

F 0 , 0 , 255

C 255 , 30 ,0

11111
11111
11111
1N111
11111
