R 600 600
SO ./textures/wood.xpm
NO ./textures/int.xpm
WE ./textures/purplestone.xpm
EA ./textures/redbrick.xpm
S ./textures/barrel.xpm

F 0 , 0 , 255

C 255 , 30 ,0

        1111111111111111111111111
        1000000000110000000000001
        1011000001110000002000001
        1001000000000000000000001
111111111011000001110000000000001
100000000011000001110111111111111
11110111111111011100000012021
11110111111111011101010010201
11000000110101011100000010001
10002000000000001100000010001
10000000000000001101010000001
11000001110101011111011110W0111
11110111 1110101 101111010001
11111111 1111111 111111111111
