R 400 400
NO ./textures/btc.xpm
SO ./textures/btc.xpm
WE ./textures/int.xpm
EA            ./textures/dollar.xpm
S  ./textures/btc.xpm

F 0 , 0 , 255

C 255 , 30 ,0


        1111111111111111111111111
        1000000000110000000000001
        1011000001110001002010101
        1001000000000000000000001
11111111101100000111000N000000001
100000000011000001110110111111111
11110111111111011100000010001
11110111111111011101010010001
11000000110101011100000010001
10002000000000001100000010001
10000000000000001101010010001
1100000111010101111101111000111
11110111 1110101 101111010001
11111111 1111111 111111111111
