R 600 600
NO ./textures/int.xpm
SO ./textures/wood.xpm
WE ./textures/purplestone.xpm
EA ./textures/redbrick.xpm
S ./textures/barrel.xpm

F 0 , 0 , 255

C 255 , 30 ,0

11111111
10000001
10002001
10000001111
102000000001
1000000000201
10000W0000021
1111111111111
